semi na nahau
- ni maneno yenye maana maalum ambayo hayajatokana na maana za kawaida za maneno hayo. [metaphorical idioms]

mifano
kupata jiko - kuoa
kukuna kichwa - kufikiria [scratch]
kwenda jongomeo - kufa [hell MARAFUKU!]
kulaza damu - mzembe
kupata nafuu - kupona - get well (or feel relief)
kuuma meno au kumeza mate - machungu - kuvumilia matatizo [swallow]
kupiga maji - kulewa (get drunk)
kupiga miguu - kutembea
kuchemkiwa na damu - kukasirika [angry]
kuwa na mate ya fisi - kuwa na tamaa
kutiwa mbaroni - kukamatwa [kutia is to add a little bit into.]
kula kalenda - fungwa gerezani [prison]
kula gumzo - kuzungumza [gumzo is talk]
kufua dafu - kushinda
kushika usukani - kuongoza
kuwa na mkono wa birika - mchoyo [hand comes down not up, not a giving hand]
kung'oa nanga - kuondoka [start a journey: to remove ballast]
kukata kiu - kumaliza kiu ya maji [thirst]
kuuma meno au kumeza [swallow] mate machungu - kuvumilia matatizo
kupigwa kalamu au kumwaga unga au kuonyeshwa mlango - kufukuzwa kazini [lose job]


time is a vehicle:  
nimekuja kwa muda wa miaka mitatu.
nimekuja kwa gari.

reference:
pepo - spirit
nafsi - soul 
kuvuma - sound the noise makes
kipepo - wind?
pepo - spirit
upepo - wind
kuvumilia - to have frustration inside yourself. maybe you're making a noise like the wind
kupuuza - to leave [ignore]
deni - debts
dini - religion
madini - mineral
katoliki - Catholic
shirika - organization
ya mwisho - last
